+--+--+--+--+
|           |
+  +--+     +
|  |        |
+  +  +--+--+
|  |        |
+  +--+--+  +
|        | g|
+--+--+--+--+